       XXXXXXXXXXX
       X   X     X
XXXXX  X     * * X
X   XXXXX *XX X XX
X * XX   X XX *  X
X *  @** X XX*** X
XX XXX   X XX    X
XX X   XXX XXXXX*X
XX X     *  X....X
X  XXX XX * X....XX
X *   * X   X..*. X
X  XX * X  XX.... X
XXXXX   XXXXXX...XX
    XXXXX    XXXXX
