XXXXX
X   XX
X *  XXXXXXXXX
XX X X       XXXXXX
XX X   *X*X@  X   X
X  X      * X   * X
X  XXX XXXXXXXXX XX
X  XX ..*..... X XX
XX XX *.*..*.* X XX
X *XXXXXXXXXX XX* X
X  *   *  *    *  X
X  X   X   X   X  X
XXXXXXXXXXXXXXXXXXX
