XXXXXXXXXXXXXXXXXXXX
X     X     @X...XXX
X     X      XX...XX
X X X XX*XX XX ....X
X   * X   ***  ....X
XXX*XXX **  XXX XX.X
X     *  X    X XXXX
X  *  X  XXX  X X  X
XX X*XX    *  **   X
X   * XX   X  X X  X
X     X    X  X    X
XXXXXXXXXXXXXXXXXXXX
