  XXXXXXXXXXXXXXXXX
XXX@XX         ...X
X    X         ...X
X *  X         ...X
X ** X         ...X
XX * XXX*XXXXXXXXXX
 X XXX  * X
XX   *  * X
X  * X  * X
X *  X    X
X  * X    X
X    X    X
XXXXXXXXXXX
