
           XXXXX    
          XX   XX   
         XX     X   
        XX  **  X   
       XX **  * X   
       X *    * X   
XXXX   X   ** XXXXX 
X  XXXXXXXX XX    X 
X..           ***@X 
X.X XXXXXXX XX   XX 
X.X XXXXXXX. X* *XXX
X........... X   * X
XXXXXXXXXXXXXX  *  X
             XX  XXX
              XXXX  

