      XXXXXXXXXXXX
     XX..    X   X
    XX..* *    * X
   XX..*.X X X *XX
   X..*.X X X *  X
XXXX...X  X    X X
X  XX X          X
X @* * XXX  X   XX
X *   *   X X   X
XXX**   X X X X X
  X   *   X X XXXXX
  X *X XXXXX      X
  X*   X   X    X X
  X  XXX   XX     X
  X  X      X    XX
  XXXX      XXXXXX
