  XXXXXXXXX
  X*.*X*.*X
  X.*.*.*.X
  X*.*.*.*X
  X.*.*.*.X
  X*.*.*.*X
  XXX   XXX
    X   X
XXXXXX XXXXXX
X           X
X * * * * * X
XX * * * * XX
 X* * * * *X
 X   *@*   X
 X  XXXXX  X
 XXXX   XXXX
