XXXXXXXXXXXXXXXXXXXX
XXXXX@XXX.XX...XX  X
XXXXX*  ..X...X    X
XXXX    ......X  * X
XXX  * X.....XX X XX
XX  **X XXXXX  * * X
XX *X *    XX  **  X
XX  X  X    X *  * X
XX   ** XXX X*XX   X
XX *X      * *  * XX
XXX    X    X    XXX
XXXXXXXXXXXXXXXXXXXX
