
XXXXXXXXXXX          
X......   XXXXXXXXX  
X......   X  XX   X  
X..XXX *    *     X  
X... * * X  XXX   X  
X...X*XXXXX    X  X  
XXX    X   X*  X *XXX
  X  ** * *  *XX  * X
  X  *   X*X  XX    X
  XXX XX X  * XXXXXXX
   X  * * XX XX      
   X    *  *  X      
   XX   X X   X      
    XXXXX@XXXXX      
        XXX          

