XXXXXXXXXXXXXXXXXXXX
X   X  X@X XX  XXXXX
X X X  *    *  XXXXX
X X    XXXXXX *  XXX
X   X  X....X  **  X
XX*XX*XX....X      X
X      X....XX*XX*XX
X  **  X....X      X
X *  *  X  X  XXX  X
XXXXX  *   *    *  X
XXXXX X    X  X   XX
XXXXXXXXXXXXXXXXXXXX
