XXXX
X  XXXXXXXXXXXXXX
X  X   ..X......X
X  X X XXXXX ...X
XX*X    ........X
X   XX*XXXXXX  XXXX
X * X     XXXXXX@ X
XX* X *   XXXXXX  X
X  * X***XX       X
X      X    X*X*XXX
X XXXX X*****    X
X X    *     X   X
X X   XX        XXX
X XXXXXX*XXXXXX * X
X        X    X   X
XXXXXXXXXX    XXXXX
