
XXXXXXXXXX    
X        XXXX 
X XXXXXX X  XX
X X * * *  * X
X       X*   X
XXX*  **X  XXX
  X  XX X *XX 
  XX*X   * @X 
   X  * * XXX 
   X X   *  X 
   X XX   X X 
  XX  XXXXX X 
  X         X 
  X.......XXX 
  X.......X   
  XXXXXXXXX   

