
   XXXXXXXXXX   
   X..  X   X   
   X..      X   
   X..  X  XXXX 
  XXXXXXX  X  XX
  X            X
  X  X  XX  X  X
XXXX XX  XXXX XX
X  *  XXXXX X  X
X X *  *  X *  X
X @*  *   X   XX
XXXX XX XXXXXXX 
   X    X       
   XXXXXX       

