     XXXXXXXX
  XXXX      XXXXXX
  X    XX * *   @X
  X XX XX*X* * *XX
XXX ......X  ** XX
X   ......X  X   X
X X ......X*  *  X
X X*...... **X * X
X   XXX XXX*  * XX
XXX  *  *  *  * X
  X  *  *  *  * X
  XXXXXX   XXXXXX
       XXXXX
