
              XXXXXX       
          XXXXX    X       
          X  XX X  XXXXX   
          X   &.X..X   X   
 XXXXX XXXX *X.X...    X   
 X   XXX  XX X&....XX XX   
 X *      XX X..X..XX X    
XXXXXX X   X X&.XXXXX X    
X   X *X*X X X..XXXXX X    
X *  *     X X&.    X X    
XX XX  * XXX X  XX  X X    
 X  *  * XXX XXXXX XX X    
 XXX*XXX*XXX  XXXX XX X    
XXXX X         XXX  X X    
X  * X  *XXXX  XXX**X@XXXXX
X      * X X  XXXX  X*X   X
XXXX X  *X X              X
   X  *  X XX  XX  XXXXXXXX
   XX  XXX  XXXXXXXX       
    XXXX                   

