             XXXXXX
 XXXXXXXXXXXXX....X
XX   XX     XX....X
X  **XX  * @XX....X
X      ** *X  ....X
X  * XX ** X X ...X
X  * XX *  X  ....X
XX XXXXX XXX XX.XXX
XX   *  * XX   .  X
X *XXX  X XXXXX XXX
X   *   X       X
X  * X* * *XXX  X
X ***X *   X XXXX
X    X  ** X
XXXXXX   XXX
     XXXXX
