 XXXXXXXXXXXXXXXXX
 X...   X    X   XX
XX.....  *XX X X* X
X......X  *  X    X
X......X  X  X X  X
XXXXXXXXX *  * *  X
  X     X*XX* XX*XX
 XX   *    X *    X
 X  XX XXX X  XX* X
 X * **     *  *  X
 X *    *XX* XXXXXX
 XXXXXXX  @ XX
       XXXXXX
