XXXXXXXXXXXXXXXXXXXX
X@     XXX   X  X  X
X X X  X  *  *     X
XXXXX     X * *X*X X
X.X..X    XX* *    X
X.....    *   X   XX
X.....    XXX*XX*XXX
X.X..X    *    X   X
XXXXX     X  X*  * X
XXXXX  X  *    * * X
XXXXX  X  X  X  X  X
XXXXXXXXXXXXXXXXXXXX
