XXXXXXXXXXXXXXXXXXXX
X....XXX           X
X....XXXXX X  X*X XX
X....XXX   X*  *   X
X....XXX    *  X**XX
XX  XXXX *X  X* *  X
XX  XXXX  *  *  X  X
X@  XXXX*XXX*XX *  X
XX        X  X  *  X
XX   XXX  X  *  XXXX
XXXXXXXX  X  X     X
XXXXXXXXXXXXXXXXXXXX
