XXXXXXXXXXXXXXXXXXXX
X....X       X  X  X
X....X X *  *      X
X.... XX  *X X *X* X
X...X   *   *X  *  X
X..XXXX  X *   **  X
X      XXXX XXXX XXX
X        X   X     X
X XX   X   * X * * X
X XX    * XX *  *  X
X     @X     X   X X
XXXXXXXXXXXXXXXXXXXX
