              XXXXX
     XXXXXXXXXX   X
     X        X   X
     X  * *    ** X
     X XXXXX XX * X
     X**   X*XX * X
     X XXX X XX*  X
XXXXXX XXX * *    X
X....        XX   X
X....        XXXXXX
X....        X
XXXXXXXXXXX@XX
          XXX
