XXXXXXXXXXXX XXXXXX
X   X    X XXX....X
X   **X   @  .....X
X   X XXX   X ....X
XX XX XXX  X  ....X
 X * *     X X XXXX
 X  * *XX  X      X
XXXX X  XXXX X XX X
X  X X*   XX X    X
X *  *  X XX X   XX
X X * *    X X   X
X  * XX XX X XXXXX
X **     **  X
XX XX XXX *  X
 X    X X    X
 XXXXXX XXXXXX
