
      XXXXXXXXXXXX    
      X  .  XX   X    
      X X.     @ X    
 XXXXXX XX...X XXXX   
XX  XX...XXXX     XXXX
X * XX...    * X  *  X
X     .. XX X XX XX  X
XXXX*XXX*X *  X   X XX
 XXX  X    XX* ** X X 
 X   ** X X * X *XX X 
 X                  X 
 XXXXXXXXXXXXXXXXX  X 
                 XXXX 

