XXXXXXXXXXXXXXXXXXXX
X    X  X X  X  X  X
X @X X XX *   *   XX
XXXX X    X  X *   X
X    X XX X* XX XX X
X      *   *   *   X
X..XXX**XX *XX* XX X
X..X.X  X *   * X  X
X....X **   XX* XXXX
X....X  XXXXX      X
X...XXX        XX  X
XXXXXXXXXXXXXXXXXXXX
