
                XXXXX   
       XXXXXX XXX   XXXX
   XXXXX    XXX * *  * X
XXXX  XX X* *    * X   X
X....   ** * *  *   X*XX
X.. X XX X   XXX*XX X  X
X....    X XXX    X    X
X....    X XX  *  XXX* X
X..XXXXXX  *  X  XXXX XX
XXXX    X   XXX    @  X 
        XXXXXXXXXXXXXXX 

