
        XXXXXXX    
    XXXXX  X  XXXX 
    X   X   *    X 
 XXXX X** XX XX  X 
XX      X X  XX XXX
X  XXX *X*  *  *  X
X...    X XX  X   X
X...X    @ X XXX XX
X...X  XXX  *  *  X
XXXXXXXX XX   X   X
          XXXXXXXXX

