
       XXXX     
       X  XX    
       X   XX   
       X ** XX  
     XXX*  * XX 
  XXXX    *   X 
XXX  X XXXXX  X 
X    X X....* X 
X X   * ....X X 
X  * X X.&..X X 
XXX  XXXX XXX X 
  XXXX @*  XX*XX
     XXX *     X
       X  XX   X
       XXXXXXXXX

