XXXXXX  XXXXX
X    X  X   X
X *  XXXX * X
X *      *  X
X  XXX@XXX* X
XXXXXXXXXX XXX
X..   XX     X
X..   XX*    X
X..   XX *   X
X..   XX *   X
X..     * *  X
XXX  XXXXXXXXX
  XXXX
