XXXXXX     XXXX
X    XXXXXXX  XXXXX
X   *X  X  *  X   X
X  *  *  * X * *  X
XX* *   X @X *    X
X  * XXXXXXXXXXX XX
X X   X.......X *X
X XX  X ......X  X
X X   *........* X
X X * X.... ..X  X
X  * *XXXX*XXXX *X
X *   XXX *   *  XX
X *     * *  *    X
XX XXXXXX * XXXXX X
X         X       X
XXXXXXXXXXXXXXXXXXX
