           XXXXXXXX
           X  ....X
XXXXXXXXXXXX  ....X
X    X  * *   ....X
X ***X*  * X  ....X
X  *     * X  ....X
X ** X* * *XXXXXXXX
X  * X     X
XX XXXXXXXXX
X    X    XX
X     *   XX
X  **X**  @X
X    X    XX
XXXXXXXXXXX
