XXXXXXXXXXXXXXXXXXXX
X      ....X    XXXX
X      ....        X
X X XXXXXXXXXX     X
X X*   X      XXX..X
X  *   X**XXX   X..X
X * XXX *   *   X..X
X * X   * * X  XX..X
X  X  ** X * XX   XX
X@XX *X  *  *     XX
XX       XX   X  XXX
XXXXXXXXXXXXXXXXXXXX
