    XXXXX
 XXXX   XX XXXXX
 X  *    XXX   X
 X *@* *    *  X
 X X*XXXXXXXX XX
 X X  *  X     X
 X X * * X X   X
XX X  *X X XXXXX
X  XX    X     X
X    * X XXX   X
XXXXX XX  X....X
X    *     ....X
X         X....X
XXXXXXXXXXXXXXXX
