 XXXXXXXXXXXXXXXXXX
 X   *       ...X.XX
 X       XXXX..... X
 X XXXXXXX  X..... X
 X X    * * XX....XX
 X X  * X X XXX...X
 X X *@* *  XXXXX X
XX X  *  * **   * X
X  X*X *X   X *XX X
X XX    XX XX * X X
X X *X * *  X     X
X X         XXXXXXX
X XXXXXXXX*XX   X
X        X  *   X
XXXXXXXX    XXXXX
       XXX  X
         XXXX
