    XXXXXX
 XXXX    X
 X    XX X
 X *     X
XXX XXXX XXXXXXXX
X  *   * XX  ...X
X   ** **    ...X
X    *  *XX  ...X
XX@XX XX XX  ...X
 XXX  *  XXXXXXXX
 X   **  X
 X    X  X
 XXXXXXXXX
