XXXXXXX XXXXXXXXX
X     X X   XX  X
X XXX X X   *   X
X X * XXX   *   X
X   **      XX* X
X    XXXX   XX  X
X@XXXXXXXXXXXX XX
XXX..    XXXXX* X
  X..    XXXX   X
  X..       **  X
  X..    XXXX * X
  X..    X  X   X
  XXXXXXXX  XXXXX
