XXXXXXXXXXXXXXXX
X       X@ X   X
X X X X X *  **X
X X...X X***   X
X  ...X X *  **XX
X XX.XX X XX    X
X X...     *    X
X XX XXX  XXXXXXX
X    X XXXX
XXXXXX
