    XXXXXXXXXX
XXXXX        XXXX
X     X   *  X@ X
X XXXXXXX*XXXX  XXX
X X    XX X  X* ..X
X X *     X  X  X.X
X X *  X     X* ..X
X X  XXX XX     X.X
X XXX  X  X  X* ..X
X X    X  XXXX  X.X
X X*   *  *  X* ..X
X    * X * * X  X.X
XXXX *XXX    X* ..X
   X    ** XXX....X
   X      XX XXXXXX
   XXXXXXXX
