XXXXXXXXXXXXXXXXXXXX
X     X  X...X@    X
X X       ....X    X
X  *  X   X....X   X
X XX*XXXX XX....X  X
X *   *  X  X...X  X
X ** X   X   X **  X
XXX  ***X   **  *  X
X *  X  X    X *X  X
X   *X  X       *  X
X  X    X    X  X  X
XXXXXXXXXXXXXXXXXXXX
