XXXXXXXXXXXXXXXXXXXX
X   X    X   X   X@X
X *      *   *   X X
XX XXX..XX XXX     X
X   X....X*X  *XXX X
X * X....X  *  * * X
X   X....X X X * * X
X   XX..XX   X*X   X
XX*XX    XX  X  X*XX
X   *  *     X  X  X
X   X    X   X     X
XXXXXXXXXXXXXXXXXXXX
