XXXXXXXXXXXXXXXXXXXX
X..X    X          X
X.*  *  X**  *XX *XX
X.*X  XXX  XX XX   X
X  X * X  **   *   X
X XXX  X X  X*  XXXX
X  XX X *   X@ X   X
X *    *  XX.XX  * X
X  X *X *X *     XXX
X  X  X  X   XXX   X
X  XXXXXXXX X      X
X           X  X.X.X
XX*XXXXXXXX*X   ...X
X    .*  X    XX.X.X
X .*...*   *  .....X
XXXXXXXXXXXXXXXXXXXX
