XXXXXXXXXXXXXXXXXXXX
X  X  XX    X   @XXX
XX    *    X *XXX  X
XX*X * XX*X * *    X
X   *X    *      XXX
X XX   * XXX  X....X
X X *X X X X X....XX
X    * * X  X....XXX
XX* XXX  * X....XXXX
X  X *        XXXXXX
X      X X    XXXXXX
XXXXXXXXXXXXXXXXXXXX
