     XXXXXXXXXXX
     X  .  X   X
     X X.    @ X
 XXXXX XX..X XXXX
XX  X ..XXX     XXX
X * X...   * X  * X
X    .. XX  XX XX X
XXXX*XX*X * X   X X
  XX X    X* ** X X
  X  * X X  X *XX X
  X               X
  X  XXXXXXXXXXX  X
  XXXX         XXXX
