
     XXXX         
   XXX  XX        
XXXX  *  X        
X   * *  XXXX     
X *   X *   X XXXX
X  X  X   * X X..X
XX*X* XXXX*XXXX..X
 X   XXXXX XX ...X
 X*X XX@XX XX  ..X
 X X    *     ...X
 X   XXXX XXX  ..X
 XXX XX X  XX ...X
  XX* XXXX* XXX..X
  X   XX    X X..X
 XX **XX  * X XXXX
 X     **** X     
 X * XXX    X     
 X   X XXXXXX     
 XXXXX            

