    XXXXX
    X   X
    X*  X
  XXX  *XX
  X  * * X
XXX X XX X   XXXXXX
X   X XX XXXXX  ..X
X *  *          ..X
XXXXX XXX X@XX  ..X
    X     XXXXXXXXX
    XXXXXXX
