XXXXXXXXXXXXXXXXXXXX
X X X X   X@XX   X X
X             *    X
X  XX*X XXXXX * X XX
XX    XX.....X  X  X
XX*XX*X.....XXX*X* X
X   X XX.....X  X XX
X  *    XX..XX  X  X
X * X   *   *  *** X
XX *  *X X  X  *   X
X   XX   X  X      X
XXXXXXXXXXXXXXXXXXXX
