XXXXXXXXXXXXXXXXXXXX
X    @XX      X   XX
X    XX    *    * XX
X  XXX....X X X  XXX
X   X....X X X *   X
XXX X...X  X       X
XX  XX.X     *   * X
XX  * * XXX  X X XXX
XX *       X X *   X
XXXX *  *X X X X * X
XXXX         X X  XX
XXXXXXXXXXXXXXXXXXXX
