XXXXXXXXXXXXXXXXXXXX
X     X   XXXXX    X
XX *  X   XXXX  *  X
XXXX **   X..X  X  X
X  *  *  XX..XXXX XX
X *   XXX....   ** X
X  X*X   ....X X * X
X X  X * ..XXX*X   X
X X   * X..X   XX  X
X   *X  XXXX   X *XX
X X  X    @X      XX
XXXXXXXXXXXXXXXXXXXX
