XXXXXXXXXXXXX
X           X
X XXX **    X
X   X *  *  X
X  *XXXX*XXXXXX
X * XX        XXXXX
X  ** *        ...X
XXX XX **X     ...X
  X XX   X     ...X
  X      X     ...X
  XXX@XXXXXXXXXXXXX
    XXX
