XXXXXXXXXXXXXXX
X..........  .XXXX
X..........**.X  X
XXXXXXXXXXX* X   XX
X      *  *     * X
XX XXXX   X  * X  X
X      X   XX  X XX
X  *X  X XX  XXX XX
X * X*XXX    XXX XX
XXX  * X  X  XXX XX
XXX    * XX X  X XX
 X *  X  *  * *   X
 X  *  *X***  X   X
 X  X  *      XXXXX
 X @XX  X  X  X
 XXXXXXXXXXXXXX
