XXXXXXXXXXXXX
X........XXXX
X...XXXX X  XXXXX
X...X  XXX    * X
X...**     * *  X
X  .X  * *X *  XX
X...X X*X   *  X
X.X X *   *    X
X.  X*XXX*XXXX*X
XX  X   * *    X
 X  X  *@*  X  X
 X  X XXXX *  *X
 X  X    XXX   X
 X  X ** X XXXXX
 X  X    X
 XXXXXXXXX
