           XXXXXXXX
           X......X
   XXXX    X......X
   X  XXXXXXXXX...X
   X *   *    X...X
   X  X X X X X   X
XXXXX X X X@X X   X
X   X XXX XXX XX XX
X    * X * * * X X
X ***  *   X     X
X   X XXX*XXX*XX X
XXX X  *   X     X
 XX *  X * * * XXX
 X  X XXX XXX XX
 X *          X
 X  XXXXXXXXXXX
 XXXX
