XXXXXXXXXXX
X......   XXXXXXXXX
X......   X  XX   X
X..XXX *    *     X
X... * * X   XX   X
X...X*XXXXX    X  X
XXX    X   X*  X* X
  X  ** * *  *XX  X
  X  *   X*X* XX* X
  XXX XX X    XX  X
   X  * * XX XXXXXX
   X    *  *  X
   XX   X X   X
    XXXXX@XXXXX
        XXX
