XXXXXXXXXXXXXXXXXXXX
X  X     X  XX    XX
X *X   * X     XX  X
X *  *  X..X     * X
X * *  X....X   X XX
X *X  X......XXX * X
X   X  X....X  X*  X
X *  XXXX..X   X   X
XX *   XX X X *  *XX
XXX *    *X@* *X   X
XXXX   X       X   X
XXXXXXXXXXXXXXXXXXXX
