
 XXXXXXX       
 X  X  XXXXX   
XX  X  X...XXX 
X  *X  X...  X 
X * X** ...  X 
X  *X  X... .X 
X   X *XXXXXXXX
XX*       * * X
XX  X  ** X   X
 XXXXXX  XX**@X
      X      XX
      XXXXXXXX 

