XXXXXXXXXXXXXXXXXXXX
X  X  X X    X  X  X
X   *      * *     X
XX X  X*XXX*XX  XX X
X   *     *  X  *  X
X XXX*XX*X   X *   X
X X   * *  XXXXXX *X
X *  ** *  X@X.X...X
X X     X  X X.X...X
X XXXXXXXXXX X.....X
X            X.....X
XXXXXXXXXXXXXXXXXXXX
