       XXXXX
 XXXXXXX   XX
XX X @XX ** X
X    *      X
X  *  XXX   X
XXX XXXXX*XXX
X *  XXX ..X
X * * * ...X
X    XXX...X
X ** X X...X
X  XXX XXXXX
XXXX
