
       XXXXXXXXXXXX 
       X..........X 
     XXX.X.X.X.X..X 
     X   .........X 
     X@ * * * &.&.X 
    XXXXXXX XXXXXXX 
 XXXX   X    XX  X  
XX    * X    X * XX 
X  X*X XXX XXX*   XX
X *  * *   X * * * X
X  X * XX       X* X
X   *XXXX*XXXX*XX  X
XXXX  XX   X    X  X
   X* XX   X X **  X
   X   X * X  *    X
   XXX X ** X  * XXX
     X X    X * XX  
     X XXXXXXXX X   
     X          X   
     XXXXXXXXXXXX   

