
      XXXXXX             
   XXXXX   X             
   X   X X XXXXX         
   X * X  *    XXXXXX    
  XX*  XXX XX       X    
XXX  ** * * X  XX   XXXXX
X       *   XXXXXX XX   X
X  XXXXXXXX X@   X X  X X
XX XXX      XXXX X*X X  X
 X XXX XXXX XX.. X   * XX
 X  *  *  X*XX.. X*XX  XX
 X  X X X     ..XX XX * X
 XXXX   X XX X..X    *  X
    XXXXX    X..X X X  XX
        XXXXXX..X   X XX 
             X..XXXXX  X 
             X..       X 
             XX  XXX  XX 
              XXXXXXXXX  

