  XXXX
  X  XXXXXXXXXXX
  X    *   * * X
  X *X * X  *  X
  X  * *  X    X
XXX *X X  XXXX X
X@X* * *  XX   X
X    * X*X   X X
X   *    * * * X
XXXXX  XXXXXXXXX
  X      X
  X      X
  X......X
  X......X
  X......X
  XXXXXXXX
