XXXXXXXXXXXXXXXXXXXX
X@     X   X       X
XX XXX XX  XXXX X XX
X    X X  **       X
X  X X X * X * XX XX
X     * X  X** X   X
X  XXX  X      XX XX
X..X.X * X  * X    X
X..X.X  * X XX **  X
X....XX   **  *  X X
X.....XX        X  X
XXXXXXXXXXXXXXXXXXXX
