
  XXXX            
  X  XXXXXXXXX    
 XX  XX @X   X    
 X  *X * *   XXXX 
 X*  *  X * *X  XX
XX  *XX X* *     X
X  X  X X   ***  X
X *    *  *XX XXXX
X * * X*X  X  X   
XX  XXX  XXX* X   
 X  X....     X   
 XXXX......XXXX   
   X....XXXX      
   X...XX         
   X...X          
   XXXXX          

