XXXXXXXXXXXXXXXXXXXX
X                XXX
X *X   * XX  *    XX
X    *XXX    X ** XX
X.XXX     * * XX  XX
X...X  X  X    X*  X
X..XX**XXXX *  X   X
X...X      * XX  XXX
X...*  XXX  X    X X
XX..  *X  XX   XX@ X
XXX.X              X
XXXXXXXXXXXXXXXXXXXX
