       XXXXXXXXXXX
       X         X
       X    * *  X
XXXXXX X * XXXXX X
X    XXXXX *  XX*X
X       * *      X
X          XX XX X
X    XX@XXXXX XX X
X    XXXX   X XX XX
X....X      X *   X
X....X      X     X
XXXXXX      XXXXXXX
