XXXXXXXXXXXXXXXXXXXX
X        X   X@ X  X
X **  X**X X X  XX X
X  X * * X** X     X
XX X  X  X X X  X  X
X   XX       X     X
X   X * X   X   X  X
X * X* X   X  * X..X
XX* X  XXXX    X...X
X  *          X....X
X   X  X     X.....X
XXXXXXXXXXXXXXXXXXXX
