
 XXXX                
XX  XXXXX            
X       X XXXXX      
X *XXX  XXX   X      
X..X  *X X  X X      
X..X      **X XXX    
X.&X X  X* *    XXXXX
X..X  XX     XX*X   X
X.&*  * X XX  *     X
X..XX  *   X   XXXXXX
X.&XX*XX   XXXXX     
X..  * XXXXX         
X  X @ X             
XXXXXXXX             

