
XXXXX XXXX      
X...X X  XXXX   
X...XXX  *  X   
X....XX *  *XXX 
XX....XX   *  X 
XXX... XX * * X 
X XX    X  *  X 
X  XX X XXX XXXX
X * X X*  *    X
X  * @ *    *  X
X   X * ** * XXX
X  XXXXXX  XXX  
X XX    XXXX    
XXX             

