 XXX  XXXXXXXXXXXXX
XX@XXXX       X   X
X **   **  * * ...X
X  ***X    *  X...X
X *   X ** ** X...X
XXX   X  *    X...X
X     X * * * X...X
X    XXXXXX XXX...X
XX X  X  * *  X...X
X  XX X ** * *XX..X
X ..X X  *      X.X
X ..X X *** *** X.X
XXXXX X       X X.X
    X XXXXXXXXX X.X
    X           X.X
    XXXXXXXXXXXXXXX
