    XXXXXXX
    X  X  XXXX
XXXXX *X* X  XX
X.. X  X  X   X
X.. X *X* X  *XXXX
X.  X     X*  X  X
X..   *X  X *    X
X..@X  X* X*  X  X
X.. X *X     *X  X
X.. X  X**X*  X  XX
X.. X *X  X  *X*  X
X.. X  X  X   X   X
XX. XXXX  XXXXX   X
 XXXX  XXXX   XXXXX
