XXXXXXXXXXXX
X      X   XX
X *  *   X  XXXXXX
XXXX  XXXXX      X
 X..  X     XXXX X
 X.XXXX  XXXX    X
 X....    X  * XXXX
 X ...X   X ***X  XX
XXX.XXXX XX  *@*   X
X     XXXXX * X    X
X X.X *      *XXX* X
X X.XXXXXXXX  X  * X
X X..        XX  * X
X X XXXXXXX * X X  X
X   X     X       XX
XXXXX     XXXXXXXXXX
