         XXXX
 XXXXXXXXX  XX
XX  *      * XXXXX
X   XX XX   XX...X
X X** * **X*XX...X
X X   @   X   ...X
X  *X XXX**   ...X
X *  **  * XX....X
XXX*       XXXXXXX
  X  XXXXXXX
  XXXX
