            XXXXX
XXXXX  XXXXXX   X
X   XXXX  * * * X
X *   XX XX XX  XX
X   * *     *  * X
XXX *  XX XX     XX
  X XXXXX XXXXX** X
 XX*XXXXX @XX     X
 X *  XXX*XXX *  XX
 X *  X   XXX  XXX
 X ** * X   ** X
 X     X   XX  X
 XXXXXXX.. .XXX
    X.........X
    X.........X
    XXXXXXXXXXX
