XXXXXXXXXXXXXXXXXXXX
X     XXX..XXX     X
X **  XXX..XXX  *@ X
X  X XX......X  *  X
X     X......X  *  X
XXXX  XXX..XXXXXX* X
X   *** X..X    X  X
X *X   *  *  ** X* X
X  X  XX *  XX  X  X
X *    * XX *    * X
X  X  XX    XX  X  X
XXXXXXXXXXXXXXXXXXXX
