 XXXXXXXXX
 X       X
 X * ** *X
XXX X  * X
X.X   ** XX
X.XXX   * X
X.X. * XX XXXX
X...  *XX *  X
X...*   *    X
X..XXX*XXX X@X
X..X X     XXX
XXXX XXXXXXX
