
     XXXXXXXXXXXXX   
     X    XXX    X   
     X     * *  XXXX 
   XXXX X   * *    X 
  XX *  X*XXXX * * X 
XXX   X X   XXX  * X 
X *  *  X  *  X XXXX 
X XX*XXXX X*X  *  XXX
X XX  XXX X X X  *  X
X    @*   *   X * X X
XXXXX  X  XX  X *X  X
  X... XXXXX*  X  X X
  X.......X ** X* X X
  X.......X         X
  X.......XXXXXXX  XX
  XXXXXXXXX     XXXX 

