
   XXXXXXXXXX
   X  XXX   X
   X *   *  X
   X  XXXX*XX
   XX X  X  X
  XX  X.&   X
  X  XX..X  X
  X @ X.&X XX
  X X*X..X* X
  X * X..X  X
  X X X&&X  X
  X * X..X*XX
  X    .&X  X
 XXX  X  X  X
XX    XXXX  X
X  XXXXXXX*XX
X *      *  X
X  XX   X   X
XXXXXXXXXXXXX

