XXXXXXXXXXXXXXXXXXXX
X X     X          X
X       *  XX XXX XX
XXXXX  XX   *  *   X
XX..XX  X X * X X  X
X....  *     XX*X XX
X....  *XXXXX   X*XX
XX..X X  X   X  *  X
XXX.X X  *   *  X @X
XX  *  * X   X  XXXX
XX       XXXXXXXXXXX
XXXXXXXXXXXXXXXXXXXX
