
 XXXXXXXXXXXXXXXXXXXXX 
 X   XX  X   X   X   X 
 X *     *   *   *   XX
XXXXX X  X   XXX XX*XXX
X   X XX*XXXXXX   X   X
X *   X ......X   X * X
XX X  X ......XXXXX   X
XX XXXXXXXXX..X   X XXX
X          X..X *   X  
X XX XXX XXX..XX X  XXX
X X   X   XX..XX XXX  X
X   @      *..X       X
X X   X   XX  X   XX  X
XXXXX XXXXXXXXXXXXXX XX
X          X   X    * X
X *  X * * *   X X    X
X X*XX *X  XX XX    X X
X  * ** XXXX *  * X X X
X          X   X      X
XXXXXXXXXXXXXXXXXXXXXXX

