         XXXXX
     XXXXX   X
    XX *  *  XXXX
XXXXX *  * * XX.X
X       **  XX..X
X  XXXXXX XXX.. X
XX X  X    X... X
X *   X    X... X
X@ X* XX XXXX...X
XXXX  * **  XX..X
   XX  * *  *...X
    X **  * X  .X
    X   * *  XXXX
    XXXXXX   X
         XXXXX
