XXXXXXXXXXXXXXXXXXXX
X  X      X   X   XX
X *X * * XX...*  * X
X  *  X XX....X *  X
X XX * XX....X   * X
X *    X....XX *   X
X *XX  X...X       X
X   ***XX*XX  XXX XX
X X X  X   X  X    X
X * X  *  XX       X
X    X    X@       X
XXXXXXXXXXXXXXXXXXXX
